"a" = (/turf/space,/area/space)
"b" = (/turf/simulated/floor/plating/airless,/area/space)
"c" = (/obj/structure/lattice,/turf/space,/area/space)
"d" = (/mob/living/simple_animal/hostile/retaliate/melterling,/turf/simulated/floor/plasteel/airless{icon_state = "damaged4"},/area/space)
"e" = (/turf/simulated/wall/r_wall/rust,/area/space)
"f" = (/turf/simulated/floor/plasteel/airless{icon_state = "damaged4"},/area/space)
"g" = (/turf/simulated/floor/plasteel/airless{icon_state = "floorscorched1"},/area/space)
"h" = (/turf/simulated/floor/plasteel/airless{icon_state = "damaged5"},/area/space)
"i" = (/mob/living/simple_animal/hostile/retaliate/melterling,/turf/simulated/floor/plasteel/airless{icon_state = "floorscorched1"},/area/space)

(1,1,1) = {"
aaaaaaaaaaaaaaa
aaaaaaaaaaaaaaa
aaaaaaaaaaaaaaa
aaabaaaaaaaaaaa
aabcaaaaaaaaaaa
aaacaaaaaabbaaa
aaaaaaabaccccba
acbaaabccccbaaa
accaaaacacaacaa
aaaaaaaccabccca
aaaaaaabcacadea
aaaaaaaacafbgea
aaaaaaaachfigea
aaaaaaaaeeeeeea
aaaaaaaaaaaaaaa
"}
