"a" = (/turf/space,/area/space)
"b" = (/turf/simulated/mineral/asteroid,/area/space)
"c" = (/mob/living/simple_animal/hostile/retaliate/melterling,/turf/simulated/floor/plating/airless/asteroid,/area/space)
"d" = (/turf/simulated/floor/plating/airless/asteroid,/area/space)
"e" = (/obj/item/stack/sheet/metal,/turf/simulated/floor/plating/airless/asteroid,/area/space)
"f" = (/turf/simulated/mineral/iron/asteroid,/area/space)
"g" = (/obj/item/stack/rods,/turf/space,/area/space)
"h" = (/obj/item/stack/sheet/metal,/turf/space,/area/space)
"i" = (/mob/living/simple_animal/hostile/retaliate/melterling,/turf/space,/area/space)
"j" = (/obj/item/stack/sheet/metal{amount = 7},/turf/space,/area/space)

(1,1,1) = {"
aaaaaaaaaaaaaaa
aaaaaaaaabbbaaa
aaaaaaaaabcdeaa
aaaaaaaabfffdfb
aaaaaaaabdffdfb
aaaaaaaabdffdaa
aaaaagaaaddddaa
aaahaaaaaaaaaaa
aaaaaaaaaaaaaaa
afaaiaaaaaaahaa
aagaaaaaaaaaaaa
aaaaaaagaaaaaaa
aaaaaajaabaaaaa
aaaaaaaafaaaaaa
aaaaaaaaaaaaaaa
"}
