"a" = (/turf/space,/area/space)
"b" = (/obj/structure/lattice,/turf/space,/area/space)
"c" = (/turf/simulated/floor/plating/airless,/area/space)
"d" = (/turf/simulated/wall/rust,/area/space)
"e" = (/obj/item/stack/sheet/metal{amount = 7},/turf/simulated/floor/plating/airless,/area/space)
"f" = (/obj/item/stack/sheet/plasteel,/turf/space,/area/space)
"g" = (/obj/item/stack/rods{amount = 4},/turf/space,/area/space)
"h" = (/turf/simulated/mineral/iron/asteroid,/area/space)
"i" = (/turf/simulated/floor/plating/airless/asteroid,/area/space)
"j" = (/obj/effect/spawner/lootdrop/crate_spawner,/turf/simulated/floor/plating/airless/asteroid,/area/space)
"k" = (/turf/simulated/mineral,/area/space)
"l" = (/turf/simulated/mineral/random/high_chance_clown,/area/space)
"m" = (/turf/simulated/mineral/random/high_chance,/area/space)

(1,1,1) = {"
aaaaaaaaaaaaaaa
abaaaaaaaaaaaaa
abbcaaaaaaaaaaa
aadebbbabbafaaa
aaddcbaabbbbbaa
aaaabbaaagbbaaa
aaaaaaafaabbbaa
aafaaaaaaabaaaa
aaahhhiafabaaaa
aahhijhiaaaaaaa
aahiklihaaaaaaa
aahimkihaabfaad
aaihiihhaabbbbd
aaaihhaaaaaabad
aaaaaaaaaaaddad
"}
