"a" = (/turf/space,/area/space)
"b" = (/turf/simulated/mineral,/area/space)
"c" = (/turf/simulated/mineral/random/high_chance,/area/space)
"d" = (/turf/simulated/floor/plating/airless/asteroid,/area/space)
"e" = (/obj/effect/spawner/lootdrop/maintenance,/turf/simulated/floor/plating/airless/asteroid,/area/space)
"f" = (/obj/effect/spawner/lootdrop/trade_sol_rare,/turf/simulated/floor/plating/airless/asteroid,/area/space)
"g" = (/turf/simulated/mineral/asteroid,/area/space)
"h" = (/obj/effect/spawner/lootdrop/maintenance{lootcount = 2; name = "2maintenance loot spawner"},/turf/simulated/floor/plating/airless/asteroid,/area/space)
"i" = (/obj/effect/spawner/lootdrop/maintenance,/turf/space,/area/space)

(1,1,1) = {"
aaaaaaaaaaaaaaa
aaaaaaaaabbbaaa
agaaaaaacbbbbaa
aaaaaacbbbbddag
aaaaacbbbbdaaaa
aaaaccbbhddaaaa
ababbbbbdddaaaa
abbbbbfdddaaaaa
abbbbcdddaaagaa
aabbdddddaaaaaa
aaabedaaaaaaaaa
aaaaaaaaaagaaaa
aaaaaaaaaaaaaga
gaagaaaaaaiaaaa
aaaaaaagaaaaaaa
"}
