"a" = (/turf/simulated/floor/plating,/area/centcom)
"b" = (/turf/simulated/floor/plating,/area/start)
"c" = (/turf/simulated/floor/plasteel,/area/centcom)
"d" = (/turf/simulated/wall/mineral/alien,/area/centcom)
"e" = (/obj/structure/falsewall/alien,/turf/simulated/floor/plating,/area/centcom)
"f" = (/turf/simulated/wall/mineral/diamond,/area/centcom)
"g" = (/obj/structure/falsewall/diamond,/turf/simulated/floor/plating,/area/centcom)
"h" = (/turf/simulated/floor/carpet,/area/centcom)
"i" = (/obj/effect/landmark/start,/turf/unsimulated/floor,/area/start)
"j" = (/obj/effect/landmark{name = "Observer-Start"},/turf/simulated/floor/plating,/area/centcom)
"k" = (/turf/space,/area/centcom)
"l" = (/turf/simulated/wall/mineral/gold,/area/centcom)
"m" = (/obj/structure/falsewall/gold,/turf/simulated/floor/plating,/area/centcom)
"n" = (/obj/structure/alien/resin/wall,/turf/simulated/floor/snow,/area/centcom)
"o" = (/turf/simulated/floor/snow,/area/centcom)
"p" = (/turf/simulated/wall/mineral/iron,/area/centcom)
"q" = (/obj/structure/falsewall/iron,/turf/simulated/floor/snow,/area/centcom)
"r" = (/turf/simulated/wall/mineral/plasma,/area/centcom)
"s" = (/obj/structure/falsewall/plasma,/turf/simulated/floor/plating,/area/centcom)
"t" = (/obj/structure/alien/resin/membrane,/turf/simulated/floor/snow,/area/centcom)
"u" = (/turf/simulated/wall/mineral/sandstone,/area/centcom)
"v" = (/obj/structure/falsewall/sandstone,/turf/simulated/floor/plating,/area/centcom)
"w" = (/turf/simulated/wall/mineral/silver,/area/centcom)
"x" = (/obj/structure/falsewall/silver,/turf/simulated/floor/plating,/area/centcom)
"y" = (/turf/simulated/wall,/area/centcom)
"z" = (/obj/structure/falsewall,/turf/simulated/floor/snow,/area/centcom)
"A" = (/turf/simulated/wall/rust,/area/centcom)
"B" = (/turf/simulated/wall/mineral/uranium,/area/centcom)
"C" = (/obj/structure/falsewall/uranium,/turf/simulated/floor/plating,/area/centcom)
"D" = (/turf/simulated/wall/mineral/wood,/area/centcom)
"E" = (/obj/structure/falsewall/wood,/turf/simulated/floor/plating,/area/centcom)
"F" = (/turf/simulated/wall/r_wall,/area/centcom)
"G" = (/obj/structure/falsewall/reinforced,/turf/simulated/floor/snow,/area/centcom)
"H" = (/turf/simulated/wall/r_wall/rust,/area/centcom)

(1,1,1) = {"
abbbbbbbbbbbbbbbaaccccccccccccccccccccccccccccccccaaaaaaaaaaaaaaaaaaaa
abbbbbbbbbbbbbbbaaccccccccccccccccccccccccccccccccaaaaaaaaaaaaaaaaaaaa
abbbbbbbbbbbbbbbaaccdaadadedccfaafafgfcchaahaaaaccaaaaaaaaaaaaaaaaaaaa
abbbbbbbbbbbbbbbaaccaaadaaaaccaaafaaaaccaaahaaaaccaaaaaaaaaaaaaaaaaaaa
abbbbbbbbbbbbbbbaaccddaaaaaaccffaaaaaacchhaaaaaaccaaaaaaaaaaaaaaaaaaaa
abbbbbbbbbbbbbbbaaccaaadddaaccaaafffaaccaaahhhaaccaaaaaaaaaaaaaaaaaaaa
abbbbbbbbbbbbbbbaaccaaadadadccaaafafafccaaahahahccaaaaaaaaaaaaaaaaaaaa
abbbbbbbibbbbbbbjaccdaadddadccfaafffafccaaahhhahccaaaaaaaaaaaaaaaaaaaa
abbbbbbbbbbbbbbbaacceaaaaaadccgaaaaaafccaaaaaaahccaaaaaaaaaaaaaaaaaaaa
abbbbbbbbbbbbbbbaaccdadddaddccfafffaffccaahhhahhccaaaaaaaaaaaaaaaaaaaa
abbbbbbbbbbbbbbbaaccaadddaaaccaafffaaaccaahhhaaaccaaaaaaaaaaaaaaaaaaaa
abbbbbbbbbbbbbbbaaccaadddaaaccaafffaaaccaahhhaaaccaaaaaaaaaaaaaaaaaaaa
abbbbbbbbbbbbbbbaaccccccccccccccccccccccccccccccccaaaaaaaaaaaaaaaaaaaa
abbbbbbbbbbbbbbbaaccccccccccccccccccccccccccccccccaaaaaaaaaaaaaaaaaaaa
abbbbbbbbbbbbbbbaacckaakakakcclaalalmlccnoonooooccaaaaaaaaaaaaaaaaaaaa
aaaaaaaaaaaaaaaaaaccaaakaaaaccaaalaaaaccooonooooccaaaaaaaaaaaaaaaaaaaa
aaaaaaaaaaaaaaaaaacckkaaaaaaccllaaaaaaccnnooooooccaaaaaaaaaaaaaaaaaaaa
aaaaaaaaaaaaaaaaaaccaaakkkaaccaaalllaaccooonnnooccaaaaaaaaaaaaaaaaaaaa
aaaaaaaaaaaaaaaaaaccaaakakakccaaalalalccooonononccaaaaaaaaaaaaaaaaaaaa
aaaaaaaaaaaaaaaaaacckaakkkakcclaalllalccooonnnonccaaaaaaaaaaaaaaaaaaaa
aaaaaaaaaaaaaaaaaaccaaaaaaakccmaaaaaalccooooooonccaaaaaaaaaaaaaaaaaaaa
aaaaaaaaaaaaaaaaaacckakkkakkcclalllallccoonnnonnccaaaaaaaaaaaaaaaaaaaa
aaaaaaaaaaaaaaaaaaccaakkkaaaccaalllaaaccoonnnoooccaaaaaaaaaaaaaaaaaaaa
aaaaaaaaaaaaaaaaaaccaakkkaaaccaalllaaaccoonnnoooccaaaaaaaaaaaaaaaaaaaa
aaaaaaaaaaaaaaaaaaccccccccccccccccccccccccccccccccaaaaaaaaaaaaaaaaaaaa
aaaaaaaaaaaaaaaaaaccccccccccccccccccccccccccccccccaaaaaaaaaaaaaaaaaaaa
aaaaaaaaaaaaaaaaaaccpoopopqpccraararsrcctootooooccaaaaaaaaaaaaaaaaaaaa
aaaaaaaaaaaaaaaaaaccooopooooccaaaraaaaccoootooooccaaaaaaaaaaaaaaaaaaaa
aaaaaaaaaaaaaaaaaaccppooooooccrraaaaaaccttooooooccaaaaaaaaaaaaaaaaaaaa
aaaaaaaaaaaaaaaaaaccooopppooccaaarrraaccoootttooccaaaaaaaaaaaaaaaaaaaa
aaaaaaaaaaaaaaaaaaccooopopopccaaarararccoootototccaaaaaaaaaaaaaaaaaaaa
aaaaaaaaaaaaaaaaaaccpoopppopccraarrrarccoootttotccaaaaaaaaaaaaaaaaaaaa
aaaaaaaaaaaaaaaaaaccqoooooopccsaaaaaarccoooooootccaaaaaaaaaaaaaaaaaaaa
aaaaaaaaaaaaaaaaaaccpopppoppccrarrrarrccootttottccaaaaaaaaaaaaaaaaaaaa
aaaaaaaaaaaaaaaaaaccoopppoooccaarrraaaccootttoooccaaaaaaaaaaaaaaaaaaaa
aaaaaaaaaaaaaaaaaaccoopppoooccaarrraaaccootttoooccaaaaaaaaaaaaaaaaaaaa
aaaaaaaaaaaaaaaaaaccccccccccccccccccccccccccccccccccccccccccaaaaaaaaaa
aaaaaaaaaaaaaaaaaaccccccccccccccccccccccccccccccccccccccccccaaaaaaaaaa
aaaaaaaaaaaaaaaaaaccuaauauvuccwaawawxwccyooyoyzyccAooAooooccaaaaaaaaaa
aaaaaaaaaaaaaaaaaaccaaauaaaaccaaawaaaaccoooyooooccoooAooooccaaaaaaaaaa
aaaaaaaaaaaaaaaaaaccuuaaaaaaccwwaaaaaaccyyooooooccAAooooooccaaaaaaaaaa
aaaaaaaaaaaaaaaaaaccaaauuuaaccaaawwwaaccoooyyyooccoooAAAooccaaaaaaaaaa
aaaaaaaaaaaaaaaaaaccaaauauauccaaawawawccoooyoyoyccoooAoAoAccaaaaaaaaaa
aaaaaaaaaaaaaaaaaaccuaauuuauccwaawwwawccyooyyyoyccoooAAAoAccaaaaaaaaaa
aaaaaaaaaaaaaaaaaaccvaaaaaauccxaaaaaawcczooooooyccoooooooAccaaaaaaaaaa
aaaaaaaaaaaaaaaaaaccuauuuauuccwawwwawwccyoyyyoyyccooAAAoAAccaaaaaaaaaa
aaaaaaaaaaaaaaaaaaccaauuuaaaccaawwwaaaccooyyyoooccooAAAoooccaaaaaaaaaa
aaaaaaaaaaaaaaaaaaccaauuuaaaccaawwwaaaccooyyyoooccooAAAoooccaaaaaaaaaa
aaaaaaaaaaaaaaaaaaccccccccccccccccccccccccccccccccccccccccccaaaaaaaaaa
aaaaaaaaaaaaaaaaaaccccccccccccccccccccccccccccccccccccccccccaaaaaaaaaa
aaaaaaaaaaaaaaaaaaccBaaBaBCBccDaaDaDEDccFooFoFGFccHooHooooccaaaaaaaaaa
aaaaaaaaaaaaaaaaaaccaaaBaaaaccaaaDaaaaccoooFooooccoooHooooccaaaaaaaaaa
aaaaaaaaaaaaaaaaaaccBBaaaaaaccDDaaaaaaccFFooooooccHHooooooccaaaaaaaaaa
aaaaaaaaaaaaaaaaaaccaaaBBBaaccaaaDDDaaccoooFFFooccoooHHHooccaaaaaaaaaa
aaaaaaaaaaaaaaaaaaccaaaBaBaBccaaaDaDaDccoooFoFoFccoooHoHoHccaaaaaaaaaa
aaaaaaaaaaaaaaaaaaccBaaBBBaBccDaaDDDaDccFooFFFoFccoooHHHoHccaaaaaaaaaa
aaaaaaaaaaaaaaaaaaccCaaaaaaBccEaaaaaaDccGooooooFccoooooooHccaaaaaaaaaa
aaaaaaaaaaaaaaaaaaccBaBBBaBBccDaDDDaDDccFoFFFoFFccooHHHoHHccaaaaaaaaaa
aaaaaaaaaaaaaaaaaaccaaBBBaaaccaaDDDaaaccooFFFoooccooHHHoooccaaaaaaaaaa
aaaaaaaaaaaaaaaaaaccaaBBBaaaccaaDDDaaaccooFFFoooccooHHHoooccaaaaaaaaaa
aaaaaaaaaaaaaaaaaaccccccccccccccccccccccccccccccccccccccccccaaaaaaaaaa
aaaaaaaaaaaaaaaaaaccccccccccccccccccccccccccccccccccccccccccaaaaaaaaaa
aaaaaaaaaaaaaaaaaaaaaaaaaaaaaaaaaaaaaaaaaaaaaaaaaaaaaaaaaaaaaaaaaaaaaa
aaaaaaaaaaaaaaaaaaaaaaaaaaaaaaaaaaaaaaaaaaaaaaaaaaaaaaaaaaaaaaaaaaaaaa
aaaaaaaaaaaaaaaaaaaaaaaaaaaaaaaaaaaaaaaaaaaaaaaaaaaaaaaaaaaaaaaaaaaaaa
aaaaaaaaaaaaaaaaaaaaaaaaaaaaaaaaaaaaaaaaaaaaaaaaaaaaaaaaaaaaaaaaaaaaaa
aaaaaaaaaaaaaaaaaaaaaaaaaaaaaaaaaaaaaaaaaaaaaaaaaaaaaaaaaaaaaaaaaaaaaa
aaaaaaaaaaaaaaaaaaaaaaaaaaaaaaaaaaaaaaaaaaaaaaaaaaaaaaaaaaaaaaaaaaaaaa
aaaaaaaaaaaaaaaaaaaaaaaaaaaaaaaaaaaaaaaaaaaaaaaaaaaaaaaaaaaaaaaaaaaaaa
aaaaaaaaaaaaaaaaaaaaaaaaaaaaaaaaaaaaaaaaaaaaaaaaaaaaaaaaaaaaaaaaaaaaaa
"}
