"a" = (/turf/space,/area/space)
"b" = (/turf/simulated/mineral,/area/space)
"c" = (/turf/simulated/floor/plating/airless/asteroid,/area/space)

(1,1,1) = {"
aaaaaaaaaaaaaaaaaaaaaaaaaaaaaaaaaaaaaaaa
aaaaaabaaaaaaaaaaaaaaaaaaaaaaaaaaaaaaaaa
aaaabccaaaaaaaaaaaaaaabaaaaaaaaaaaaaaaaa
aaaacccbaaaaaaaaaaaaabbbbaaaaaaabaaaaaaa
aaaababaaaaaaaaaaaaabbccbaaaaaabbaaaaaaa
aaaaaaaaaaaaaaaaaaaabbccaaaaaaaabaaaaaaa
aaaaaaaaaaaaaaaaaaaaaaaaaaaaaaaaaaaaaaaa
aaaaaaaaaaaaaaaaaaaaaaaaaaaaaaaaaaaaaaaa
aaaaaaaaaabbbbbaaaaaaaaaaaaaaaaaaaaabaaa
aaaaaaabbbbbbbbccbcaaaaaaaaaaaaaaaaabbaa
acbaaaaabbbbbbbccccbbbbaaaaaaaaaaaaabbaa
bbbbaaaaaacccccccccbbbbcbaaaaaaaaaaabaaa
bbcaaaaacccccccccccccccccaaaaaaaaaaaaaaa
aaaaaaaabbcccccccccbcccccaaaaaaaaaaaaaaa
aaaaaaaabbbbbbcccccccbbccaaaaaaaaaaaaaaa
aaaaaabbbbbbbbcccccccccccaaaaabbaaaaaaaa
aaaaaaaabbbbbcccccbbbbcccaaaaabccaaaaaaa
aaaaaaaaaaccccccccbbbbccaaaaaaabbaaaaaaa
aaaaaaaaaaacccccccbbccccaaaaaaaaaaaaaaaa
aaaaaaaaaaacccccccbbcccaaaaaaaaaaaaaaaaa
aaaaaaaaaaabbbccccbccccaaaaaaaaaaaaaaaaa
aaaaaaaaaabbbbbcccbcccaaaaaaaaaaaaaaaaaa
aaaaaaaaaabbbbbcccbccbbaaaaaaaaaaaaaaaaa
aaaaaaaaabbbbbacccbccbbaaaaaaaabaaaaaaaa
aaaaaaaaabbbbbaccabaabaaaaaaaaaaaaaaaaaa
aaaaaaaaaaabaaaaaaaaaaaaaaaabbbaaaaaaaaa
aaabaaaaaaaaaaaaaaaaaaaaaaaabbbbaaaaaaaa
abbbaaaaaaaaaaaaaaabbbcaaaaaaabaaaaaaaaa
abbbaaaaaaaaaaaaaaabcbcaaaaaaaaaaaaaaaaa
bccaaaaaaaaaaaaaaaaaaaaaaaaaaaaaaaaaaaaa
"}
